####################
####
#########
##########
#
#
#
#    ##
#@   ###   ####   
###################