####################
####
#########
##########
#
#
#
#     ##
#@    ###   ####
###################